21
##  ######################################
##  ##                          ##      ##
##  ##  ######################  ##  ##  ##
##  ##      ##                  ##  ##  ##
##  ######  ######  ##################  ##
##      ##      ##                      ##
######  ######  ######################  ##
##  ##      ##              ##          ##
##  ######  ##########  ##  ##############
##      ##  ##      ##  ##      ##      ##
##  ##  ##  ##  ##  ######  ##  ##  ##  ##
##  ##  ##      ##      ##  ##      ##  ##
##  ##  ##############  ##  ##########  ##
##  ##              ##  ##          ##  ##
##  ######  ##  ######  ######  ######  ##
##  ##      ##  ##      ##      ##      ##
##  ##  ##  ######  ######  ######  ######
##  ##  ##  ##      ##          ##      ##
##  ##  ######  ######################  ##
##  ##                                  ##
######################################  ##
