5
##  ######
##  ##  ##
##  ##  ##
##      ##
######  ##